11111111111111111
10010C000C0010001
10C00000000010001
10001100000011111
1000110000E011111
1P001100000011111
11111111111111111
