11111111111111111
10010C000C0010001
10C00000000010001
10001100000011111
1100110000E011111
10001100010011111
11111111111111111
