11111111111111111
11111111111111111
1111111111CEP1111
11111111111111111
