111111111111111111111111111111111111111111111111111111111111111111111111111111111111111111111111111111
100100000000000000000000011PEC000100000000000010001111111111111111111111111111111111111111111111111111
100000000000000000000000011111100000000000000010001111111111111111111111111111111111111111111111111111
100011000000000000000000000000000000000000000011111111111111111111111111111111111111111111111111111111
100000000000000000000000000000000000000000001111111111111111111111111111111111111111111111111111111111
100011000000000000000000000000000000000000000011111111111111111111111111111111111111111111111111111111
111111111111111111111111111111111111111111111111111111111111111111111111111111111111111111111111111111
111111111111111111111111111111111111111111111111111111111111111111111111111111111111111111111111111111
111111111111111111111111111111111111111111111111111111111111111111111111111111111111111111111111111111
111111111111111111111111111111111111111111111111111111111111111111111111111111111111111111111111111111
111111111111111111111111111111111111111111111111111111111111111111111111111111111111111111111111111111
111111111111111111111111111111111111111111111111111111111111111111111111111111111111111111111111111111
111111111111111111111111111111111111111111111111111111111111111111111111111111111111111111111111111111
111111111111111111111111111111111111111111111111111111111111111111111111111111111111111111111111111111
111111100000000000000000000000000000000000111111111111111111111111111111111111111111111111111111111111
111111100000000000000000000000000000000000111111111111111111111111111111111111111111111111111111111111
111111100000000000000000000000000000000000111111111111111111111111111111111111111111111111111111111111
111111111111111111111111111111111111111111111111111111111111111111111111111111111111111111111111111111
111111111111111111111111111111111111111111111111111111111111111111111111111111111111111111111111111111
111111111111111111111111111111111111111111111111111111111111111111111111111111111111111111111111111111
111111111111111111111111111111111111111111111111111111111111111111111111111111111111111111111111111111
111111111111111111111111111111111111111111111111111111111111111111111111111111111111111111111111111111
111111111111111111111111111111111111111111111111111111111111111111111111111111111111111111111111111111
