111111111111111111111111111111111111111111111111111111111111111111111111111111111111111111111111111111
10010C0000000000000000000000000000000000000C0010001111111111111111111111111111111111111111111111111111
10C000000000000000000000000000000000000000000010001111111111111111111111111111111111111111111111111111
100011000000000000000000000000000000000000000011111111111111111111111111111111111111111111111111111111
100CCC000000000000000000000000000000000000001111111111111111111111111111111111111111111111111111111111
1P0011000000000000000000000000000000000000000E11111111111111111111111111111111111111111111111111111111
111111111111111111111111111111111111111111111111111111111111111111111111111111111111111111111111111111
111111111111111111111111111111111111111111111111111111111111111111111111111111111111111111111111111111
111111111111111111111111111111111111111111111111111111111111111111111111111111111111111111111111111111
111111111111111111111111111111111111111111111111111111111111111111111111111111111111111111111111111111
111111111111111111111111111111111111111111111111111111111111111111111111111111111111111111111111111111
111111111111111111111111111111111111111111111111111111111111111111111111111111111111111111111111111111
111111111111111111111111111111111111111111111111111111111111111111111111111111111111111111111111111111
111111111111111111111111111111111111111111111111111111111111111111111111111111111111111111111111111111
111111100000000000000000000000000000000000111111111111111111111111111111111111111111111111111111111111
111111100000000000000000000000000000000000111111111111111111111111111111111111111111111111111111111111
111111100000000000000000000000000000000000111111111111111111111111111111111111111111111111111111111111
111111111111111111111111111111111111111111111111111111111111111111111111111111111111111111111111111111
111111111111111111111111111111111111111111111111111111111111111111111111111111111111111111111111111111
111111111111111111111111111111111111111111111111111111111111111111111111111111111111111111111111111111
111111111111111111111111111111111111111111111111111111111111111111111111111111111111111111111111111111
111111111111111111111111111111111111111111111111111111111111111111111111111111111111111111111111111111
111111111111111111111111111111111111111111111111111111111111111111111111111111111111111111111111111111
