11111111111111
10000000000001
10000000000001
10000000C00001
100000000E0001
10111111111111
10000000000001
10000000000001
10000000000001
10000000000001
10000000000001
10000000000001
10000000000001
10000000000001
10000000000001
100000P0000001
11111111111111
11111111111111
11111111111111
11111111111111
11111111111111
11111111111111
